D00XXXXX0X00XXX
0X00000X0XX0X00
00XX0X000X0000X
X000XXXX000XXXX
000X00000XXX00X
XX0XXXX0XX000XX
000XXX0000XXXXX
0X000XX0X0XX00X
0XX0X000X000XXX
XXX00XXXX0XXXXX
XXX0XX0X00XX00X
X000X00X0XX00XX
00XX00X00000XXX
XXXXX0XX0XX0XXX
X0000XXX00X000B