D000X0X0XXX0XXX
0XX000X00000000
00X0XX00XX0X0X0
0X00000XXX0X0X0
00XXXX0XX0X000X
X000XX00X0XXX00
X0X0XXXX00000XX
X0X0X0000XXX0X0
000XX0XX0X000X0
X0XX00000X0XXX0
X000XXXX0X0000X
XXX0X0000XXX000
X000X0XXXXXX00X
X0XXX0X00000000
X00000XXX0XXXXB